The following scenario is intended to provide you with the tools that you will need to respond as safely as possible in the event of an emergency situation.

Please press SPACE to continue.

>look
Hallway South
You are at the South end of the hallway, on the second floor. There are offices to the East and West, and the hallway continues to the North.

>n
Hallway North
You are at the North end of the hallway, on the second floor. On the East wall you see a map. There are offices to the East and West, and the hallway continues to the South.

>look at map
You can't see any such thing.

* * *

>look
Hallway South
You are at the South end of the hallway, on the second floor. There are offices to the East and West, and the hallway continues to the North.

>e
South East Office
You are in an office at the South East end of the building. There is nothing here of interest.

>w
Hallway South
You are at the South end of the hallway, on the second floor. There are offices to the East and West, and the hallway continues to the North.

>w
South West Office
You are in an office at the South West end of the building. There is nothing here of interest.

>e
Hallway South
You are at the South end of the hallway, on the second floor. There are offices to the East and West, and the hallway continues to the North.

>n
Hallway North
You are at the North end of the hallway, on the second floor. On the East wall you see a map. There are offices to the East and West, and the hallway continues to the South.

You can see a map (on which is a label) here.

>look at map
You see a map of the building. At the bottom of the map you see a label. In order to get out of the building, you'll have to go North toward the elevator and the stairwell. Then you'll need to head downstairs, and South toward the exit.

On the map is a label.

* * *

The following scenario is intended to provide you with the tools that you will need to respond as safely as possible in the event of an emergency situation.

Please press SPACE to continue.

>look at map
You see a map of the building. At the bottom of the map you see some writing. In order to get out of the building, you'll have to go North toward the elevator and the stairwell.

>look at writing
You can't see any such thing.

* * *

The following scenario is intended to provide you with the tools that you will need to respond as safely as possible in the event of an emergency situation.

Please press SPACE to continue.

>look at writing
The writing at the bottom of the map says: Posted by the Emergency Building Coordinator.

>look at map
You see a map of the building. At the bottom of the map you see some writing. In order to get out of the building, you'll have to go North toward the elevator and the stairwell.

On the map is a writing.

* * *

The following scenario is intended to provide you with the tools that you will need to respond as safely as possible in the event of an emergency situation.

Please press SPACE to continue.

>n
Hallway North
You are at the North end of the hallway, on the second floor. On the East wall you see a map. There are offices to the East and West, and the hallway continues to the South.

You can see a map (on which is a label) here.

* * *

>look at map
You see a map of the building. At the bottom of the map you see a label. In order to get out of the building, you'll have to go North toward the elevator and the stairwell. Then you'll need to head downstairs, and South toward the exit.

On the map is a label.

>look at label
The label at the bottom of the map says: Posted by the Emergency Building Coordinator.

* * *

>n
Hallway North
You are at the North end of the hallway, on the second floor. On the East wall you see a map. There are offices to the East and West, and the hallway continues to the South.

You can see a map (on which is a label) here.

>n
The Elevator Doors
You see a set of large elevator doors. To the East you see stairs.

>n
You can't go that way.

>e
The Stairwell
You see stairs leading to the first and third floors of the building.

>e
You can't go that way.

>d
The First Floor Stairwell

>look
The First Floor Stairwell

>w
You can't go that way.

* * *

>n
Hallway North
You are at the North end of the hallway, on the second floor. On the East wall you see a map. There are offices to the East and West, and the hallway continues to the South.

You can see a map (on which is a label) here.

>s
Hallway South
You are at the South end of the hallway, on the second floor. There are offices to the East and West, and the hallway continues to the North.

* * *

The following scenario is intended to provide you with the tools that you will need to respond as safely as possible in the event of an emergency situation.

Please press SPACE to continue.

You want me to tell you that this is just a game, but I won't. The truth is that any of the things that you read here could happen to you. If you're not properly prepared for disaster, an emergency situation could easily become a horrifying experience.

 Welcome. You are about to have... 

 ... a very bad week.

Please press SPACE to continue.

You may use any of the following commands during this scenario:

Movement commands: 
north, south, east, west, up, down (or n, s, e, w, u, d)

Exploration commands: 
look, examine(or l, x)

Inventory commands: 
take, inventory(or t, i)

Speech commands: 
ask, tell, say

You may find additional commands that work, but these will be the only commands necessary to successfully complete the game.

Please press SPACE to continue.

Evacuation
An Interactive Fiction by Devin Quirozoliver
Release 1 / Serial number 120724 / Inform 7 build 6G60 (I6/v6.32 lib 6/12N) SD

The Second Floor Elevator
You don't know this yet, but you're about to have a very bad week.

Right now you need to return a book to your professor's office, but you seem to have gotten yourself lost. You seem to remember that his office is somewhere on the second floor. You need to get there before he leaves. The elevator has just arrived on the second floor. The elevator panel has buttons for the first, second and third floors.

You can see a panel here.

>l
The Second Floor Elevator
You are in the elevator on the second floor. The elevator panel has buttons for the first, second and third floors.

You can see a panel here.

>l phone
You look at your phone. The time is now 10:01 am

>l phone
You look at your phone. The time is now 10:02 am

>l watch
Time seems to have sped up.

>l phone
You look at your phone. The time is now 11:16 am

* * *

>l
The Second Floor Elevator
You are in the elevator on the second floor. The elevator panel has buttons for the first, second and third floors.

You can see a panel here.

>l watch
Time seems to have sped up. The time is now 11:15 am

* * *

>l
The Second Floor Elevator
You are in the elevator on the second floor. The elevator panel has buttons for the first, second and third floors.

You can see a panel here.

>s
Hallway North
You are at the North end of the hallway, on the second floor. The Emergency Building Coordinator is busily putting up an evacuation map on the wall.. There are offices to the East and West, and the hallway continues to the South. To the North, you see a set of old elevator doors. To the East you see stairs.

You can see a map (on which is a label), a ladder and an Emergency Building Coordinator here.

>ask EBC about professor
The EBC says: Huh? I don't know about that.

* * *

>s
Hallway North
You are at the North end of the hallway, on the second floor. The Emergency Building Coordinator is busily putting up an evacuation map on the wall.. There are offices to the East and West, and the hallway continues to the South. To the North, you see a set of old elevator doors. To the East you see stairs.

You can see a map (on which is a label), a ladder and an Emergency Building Coordinator here.

>ask ebc about professor
The EBC says: Huh? Sorry, I'm a bit busy here. Don't forget that there's going to be an evacuation drill at noon.

* * *

>s
Hallway North
You are at the North end of the hallway, on the second floor. The Emergency Building Coordinator is busily putting up an evacuation map on the wall.. There are offices to the East and West, and the hallway continues to the South. To the North, you see a set of old elevator doors. To the East you see stairs.

You can see a map (on which is a label), a ladder and an Emergency Building Coordinator here.

>ask EBC about office
You can't see any such thing.

* * *

Evacuation
An Interactive Fiction by Devin Quirozoliver
Release 1 / Serial number 120724 / Inform 7 build 6G60 (I6/v6.32 lib 6/12N) SD

The Second Floor Elevator
You don't know this yet, but you're about to have a very bad week.

Right now you need to return a book to your professor's office, but you seem to have gotten yourself lost. You seem to remember that his office is somewhere on the second floor. You need to get there before he leaves. The elevator has just arrived on the second floor. The elevator panel has buttons for the first, second and third floors.

You can see a panel here.

>i
You are carrying:
  a cell phone
  a borrowed book

>x self
As good-looking as ever.

>x me
As good-looking as ever.

>l
Hallway South
You are at the South end of the hallway, on the second floor. There are offices to the East and West, and the hallway continues to the North.

You can see a stack of papers here.

* * *

>i
You are carrying:
  a cell phone
  a borrowed book

>l phone
You look at your phone. The time is now 10:01 am

>x phone
You look at your phone. The time is now 10:02 am

* * *

Evacuation
An Interactive Fiction by Devin Quirozoliver
Release 1 / Serial number 120724 / Inform 7 build 6G60 (I6/v6.32 lib 6/12N) SD

The Second Floor Elevator
You don't know this yet, but you're about to have a very bad week.

Right now you need to return a book to your professor's office, but you seem to have gotten yourself lost. You seem to remember that his office is somewhere on the second floor. You need to get there before he leaves. The elevator has just arrived on the second floor. The elevator panel has buttons for the first, second and third floors.

You can see a panel here.

>score
You have so far scored 0 out of a possible 500, in 1 turn.

* * *

Evacuation
An Interactive Fiction by Devin Quirozoliver
Release 1 / Serial number 120724 / Inform 7 build 6G60 (I6/v6.32 lib 6/12N) SD

The Second Floor Elevator
You don't know this yet, but you're about to have a very bad week.

Right now you need to return a book to your professor's office, but you seem to have gotten yourself lost. You seem to remember that his office is somewhere on the second floor. You need to get there before he leaves. The elevator has just arrived on the second floor. The elevator panel has buttons for the first, second and third floors.

You can see a panel here.

>time
That's not a verb I recognise.

>l watch
You can't see any such thing.

>l
Hallway South
You are at the South end of the hallway, on the second floor. There are offices to the East and West, and the hallway continues to the North.

You can see a stack of papers here.

>i
You are carrying:
  a borrowed book

* * *

Evacuation
An Interactive Fiction by Devin Quirozoliver
Release 1 / Serial number 120724 / Inform 7 build 6G60 (I6/v6.32 lib 6/12N) SD

The Second Floor Elevator
You don't know this yet, but you're about to have a very bad week.

Right now you need to return a book to your professor's office, but you seem to have gotten yourself lost. You seem to remember that his office is somewhere on the second floor. You need to get there before he leaves. The elevator has just arrived on the second floor. The elevator panel has buttons for the first, second and third floors.

You can see a panel here.

>i
You are carrying:
  a watch
  a cell phone
  a borrowed book

>l watch
You look at your watch. The time is now 10:01 am

>l phone
You look at your phone. The time is now 10:02 am

* * *

Evacuation
An Interactive Fiction by Devin Quirozoliver
Release 1 / Serial number 120724 / Inform 7 build 6G60 (I6/v6.32 lib 6/12N) SD

The Second Floor Elevator
You don't know this yet, but you're about to have a very bad week.

Right now you need to return a book to your professor's office, but you seem to have gotten yourself lost. You seem to remember that his office is somewhere on the second floor. You need to get there before he leaves. The elevator has just arrived on the second floor. The elevator panel has buttons for the first, second and third floors.

You can see a panel here.

>l watch
You look at your watch. The time is now 10:00 am

>l watch
Time seems to have sped up. The time is now 11:16 am

* * *

Evacuation
An Interactive Fiction by Devin Quirozoliver
Release 1 / Serial number 120724 / Inform 7 build 6G60 (I6/v6.32 lib 6/12N) SD

The Second Floor Elevator
You don't know this yet, but you're about to have a very bad week.

Right now you need to return a book to your professor's office, but you seem to have gotten yourself lost. You seem to remember that his office is somewhere on the second floor. You need to get there before he leaves. The elevator has just arrived on the second floor. The elevator panel has buttons for the first, second and third floors.

You can see a panel here.

>n
Hallway North
You are at the North end of the hallway, on the second floor. On the East wall you see a map. There are offices to the East and West, and the hallway continues to the South. To the North, you see a set of old elevator doors. To the East you see stairs.

You can see a map (on which is a label) and an EBC here.

>n
The Second Floor Elevator
You see a panel with buttons for the first, second and third floors.

You can see a panel here.

>l
The Second Floor Elevator
You see a panel with buttons for the first, second and third floors.

You can see a panel here.

>showme The Second Floor Elevator
The Second Floor Elevator - room
    yourself - person
        watch
        cell phone
        borrowed book
    panel
singular-named, proper-named; lighted, visited
printed name: "The Second Floor Elevator"
printed plural name: none
indefinite article: none
description: "You see a panel with buttons for the first, second and third floors."
map region: Second Floor

* * *

Evacuation
An Interactive Fiction by Devin Quirozoliver
Release 1 / Serial number 120724 / Inform 7 build 6G60 (I6/v6.32 lib 6/12N) SD

The Second Floor Elevator
You don't know this yet, but you're about to have a very bad week.

Right now you need to return a book to your professor's office, but you seem to have gotten yourself lost. You seem to remember that his office is somewhere on the second floor. You need to get there before he leaves. The elevator has just arrived on the second floor. The elevator panel has buttons for the first, second and third floors.

You can see a panel here.

>s
Hallway North
You are at the North end of the hallway, on the second floor. The Emergency Building Coordinator is busily putting up an evacuation map on the wall. There are offices to the East and West, and the hallway continues to the South. To the North, you see a set of old elevator doors. To the East you see stairs.

You can see a map (on which is a label), a ladder and an Emergency Building Coordinator here.

>n
The Second Floor Elevator
You are in the elevator on the second floor. The elevator panel has buttons for the first, second and third floors.

You can see a panel here.

* * *

>s
Hallway North
You are at the North end of the hallway, on the second floor. The Emergency Building Coordinator is busily putting up an evacuation map on the wall. There are offices to the East and West, and the hallway continues to the South. To the North, you see a set of old elevator doors. To the East you see stairs.

You can see a map (on which is a label), a ladder and an Emergency Building Coordinator here.

>ask ebc about professor
You can't see any such thing.

>tell ebc about professor
You can't see any such thing.

>l
Hallway North
You are at the North end of the hallway, on the second floor. The Emergency Building Coordinator is busily putting up an evacuation map on the wall. There are offices to the East and West, and the hallway continues to the South. To the North, you see a set of old elevator doors. To the East you see stairs.

You can see a map (on which is a label), a ladder and an Emergency Building Coordinator here.

* * *

>s
Hallway North
You are at the North end of the hallway, on the second floor. The Emergency Building Coordinator is busily putting up an evacuation map on the wall. There are offices to the East and West, and the hallway continues to the South. To the North, you see a set of old elevator doors. To the East you see stairs.

You can see a map (on which is a label), a ladder and an Emergency Building Coordinator here.

>ask ebc about prof
There is no reply.

>ask ebc about directions
There is no reply.

* * *

>ask ebc about prof
There is no reply.

>s
Hallway South
You are at the South end of the hallway, on the second floor. There are offices to the East and West, and the hallway continues to the North.

>n
Hallway North
You are at the North end of the hallway, on the second floor. The Emergency Building Coordinator is busily putting up an evacuation map on the wall. There are offices to the East and West, and the hallway continues to the South. To the North, you see a set of old elevator doors. To the East you see stairs.

You can see a map (on which is a label), a ladder and an Emergency Building Coordinator here.

>ask ebc about prof
There is no reply.

>ask EBC about prof
There is no reply.

>ask halo about prof
You can't see any such thing.

* * *

>s
Hallway North
You are at the North end of the hallway, on the second floor. The Emergency Building Coordinator is busily putting up an evacuation map on the wall. There are offices to the East and West, and the hallway continues to the South. To the North, you see a set of old elevator doors. To the East you see stairs.

You can see a map (on which is a label), a ladder and an Emergency Building Coordinator here.

>ask ebc about o
There is no reply.

* * *

>s
Hallway North
You are at the North end of the hallway, on the second floor. The Emergency Building Coordinator is busily putting up an evacuation map on the wall. There are offices to the East and West, and the hallway continues to the South. To the North, you see a set of old elevator doors. To the East you see stairs.

You can see a map (on which is a label), a ladder and an Emergency Building Coordinator here.

>ask ebc about bas
There is no reply.

>ask EBC about bas
There is no reply.

>ask Emergency Building Coordinator about BAS
There is no reply.

>ask about bas
You can't see any such thing.

* * *

>s
Hallway North
You are at the North end of the hallway, on the second floor. The Emergency Building Coordinator is busily putting up an evacuation map on the wall. There are offices to the East and West, and the hallway continues to the South. To the North, you see a set of old elevator doors. To the East you see stairs.

You can see a map (on which is a label), a ladder and an Emergency Building Coordinator here.

>ask ebc about l
Don't forget that there's going to be an evacuation drill at noon.

>w
North West Office
You are in an office at the North West end of the building. There is a Professor here who appears to be injured.

You can see a Professor here.

>e
Hallway North
You are at the North end of the hallway, on the second floor. The Emergency Building Coordinator is busily putting up an evacuation map on the wall. There are offices to the East and West, and the hallway continues to the South. To the North, you see a set of old elevator doors. To the East you see stairs.

You can see a map (on which is a label), a ladder and an Emergency Building Coordinator here.

>s
Hallway South
You are at the South end of the hallway, on the second floor. There are offices to the East and West, and the hallway continues to the North.

>w
South West Office
You are in an office at the South West end of the building. You see a desk with a stack of papers and a number of old books pertaining to your major. There is also a bookshelf with many more heavy looking books on it.

You can see a stack of papers, a desk (on which are an old books and a heavy looking books) and a bookshelf here.

>put book on table
You can't see any such thing.

>i
You are carrying:
  a watch
  a cell phone
  a borrowed book

>put borrowed book on desk
You put the borrowed book on the desk.

>e
Hallway South
You are at the South end of the hallway, on the second floor. There are offices to the East and West, and the hallway continues to the North.

>n
Hallway North
You are at the North end of the hallway, on the second floor. The Emergency Building Coordinator is busily putting up an evacuation map on the wall. There are offices to the East and West, and the hallway continues to the South. To the North, you see a set of old elevator doors. To the East you see stairs.

You can see a map (on which is a label), a ladder and an Emergency Building Coordinator here.

>ask ebc about blah
The Emergency Building Coordinator steps down from her ladder and looks at the newly minted map appraisingly. "Don't forget that there's going to be an evacuation drill at noon.", she says, cheerily.

>showme scene
There seems to be no such object anywhere in the model world.

>showme borrowed book
borrowed book - borrowable
location: on the desk in South West Office
singular-named, improper-named; unlit, inedible, portable, handled; not returned
printed name: "borrowed book"
printed plural name: "borrowables"
indefinite article: none
description: "You really should have returned this book last week, but things have just been so busy lately...."
initial appearance: none

>scenes
Scene 'Entire Game' playing (for 11 mins now)
Scene 'Returning a Book' ended
Scene 'EBC Conversation' ended
Scene 'Not a drill' playing (for 4 mins now)
(Scene monitoring now switched on. Type "scenes off" to switch it off again.)

* * *

>ask ebc about blah
The Emergency Building Coordinator steps down from her ladder and looks at the newly minted map appraisingly. "Don't forget that there's going to be an evacuation drill at noon.", she says, cheerily.

>scenes
Scene 'Entire Game' playing (for 11 mins now)
Scene 'Returning a Book' ended
Scene 'EBC Conversation' playing (for 4 mins now)
(Scene monitoring now switched on. Type "scenes off" to switch it off again.)

* * *

>ask ebc about blah
The Emergency Building Coordinator steps down from her ladder and looks at the newly minted map appraisingly. "Don't forget that there's going to be an evacuation drill at noon.", she says, cheerily.

>reset
That's not a verb I recognise.

>restart
Are you sure you want to restart?

>y
The following scenario is intended to provide you with the tools that you will need to respond as safely as possible in the event of an emergency situation.

Please press SPACE to continue.

You want me to tell you that this is just a game, but I won't. The truth is that any of the things that you read here could happen to you. If you're not properly prepared for disaster, an emergency situation could easily become a horrifying experience.

 Welcome. You are about to have... 

 ... a very bad week.

Please press SPACE to continue.

* * *

>l
The Second Floor Elevator
You are in the elevator on the second floor. The elevator panel has buttons for the first, second and third floors.

You can see a panel here.

I beg your pardon?

>s
Hallway North
You are at the North end of the hallway, on the second floor. The Emergency Building Coordinator is busily putting up an evacuation map on the wall. There are offices to the East and West, and the hallway continues to the South. To the North, you see a set of old elevator doors. To the East you see stairs.

You can see a map (on which is a label), a ladder and an Emergency Building Coordinator here.

>s
Hallway South
You are at the South end of the hallway, on the second floor. There are offices to the East and West, and the hallway continues to the North.

* * *

>w
South West Office
You are in an office at the South West end of the building. You see a desk with a stack of papers and a number of old books pertaining to your major. There is also a bookshelf with many more heavy looking books on it.

You can see a stack of papers, a desk (on which are an old books and a heavy looking books) and a bookshelf here.

>put borrowed book on desk
You put the borrowed book on the desk.

* * *

Evacuation
An Interactive Fiction by Devin Quirozoliver
Release 1 / Serial number 120724 / Inform 7 build 6G60 (I6/v6.32 lib 6/12N) SD

The Second Floor Elevator
You don't know this yet, but you're about to have a very bad week.

Right now you need to return a book to your professor's office, but you seem to have gotten yourself lost. You seem to remember that his office is somewhere on the second floor. You need to get there before he leaves. The elevator has just arrived on the second floor. The elevator panel has buttons for the first, second and third floors.

You can see a panel here.

>showme scene
There seems to be no such object anywhere in the model world.

>showme current scene
There seems to be no such object anywhere in the model world.