room_grid
An Interactive Fiction by Devin Quirozoliver
Release 1 / Serial number 120708 / Inform 7 build 6G60 (I6/v6.32 lib 6/12N) SD

Center
The Center is in the center of a nine room grid.

>look
Center
The Center is in the center of a nine room grid.

>n
You can't go that way.

* * *

room_grid
An Interactive Fiction by Devin Quirozoliver
Release 1 / Serial number 120708 / Inform 7 build 6G60 (I6/v6.32 lib 6/12N) SD

Center
The Center is in the center of a nine room grid.

>look w
You see nothing unexpected in that direction.

>w
room named The West Wing
The West is in the West of a nine room grid.

* * *

room_grid
An Interactive Fiction by Devin Quirozoliver
Release 1 / Serial number 120708 / Inform 7 build 6G60 (I6/v6.32 lib 6/12N) SD

Center
The Center is in the center of a nine room grid.

>w
The West Wing
The West is in the West of a nine room grid.

>e
Center
The Center is in the center of a nine room grid.

* * *

room_grid
An Interactive Fiction by Devin Quirozoliver
Release 1 / Serial number 120708 / Inform 7 build 6G60 (I6/v6.32 lib 6/12N) SD

Center
The Center is in the center of a nine room grid.

>help
That's not a verb I recognise.

>look
Center
The Center is in the center of a nine room grid.

>ne
The NorthEast Wing
The NorthEast is in the NorthEast of a nine room grid.

>sw
Center
The Center is in the center of a nine room grid.

>sw
The SouthWest Wing
The SouthWest is in the SouthWest of a nine room grid.

* * *

room_grid
An Interactive Fiction by Devin Quirozoliver
Release 1 / Serial number 120708 / Inform 7 build 6G60 (I6/v6.32 lib 6/12N) SD

Center
The Center is in the center of a nine room grid.

>sw
The SouthWest Wing
The SouthWest is in the SouthWest of a nine room grid.

>se
You can't go that way.

>look
The SouthWest Wing
The SouthWest is in the SouthWest of a nine room grid.

>ne
Center
The Center is in the center of a nine room grid.

>sw
The SouthWest Wing
The SouthWest is in the SouthWest of a nine room grid.